111111111111111111111111111111111
111000000N00000000000000000000011
1100N1NNNNN0000000000000P00000011
10000C100000000000000000000000001
1000111110C00000C0000000000000011
100000000000001110000000010000111
100000000000001110000000000000111
1000111110C00000C000C000000000011
100000000000001110000000000000011
1000111110C00000C000C000000000011
100CECC000C0000000000000000000011
1000111110C00000C000000000000C011
100000000000001110000000000000011
1000111110C00000C000C000000000011
100000000000001110000000000000011
111111111111111111111111111111111