111111111111111111111111111111111
10100000P000000000000000000000011
1100000000N0000000000000000000011
10000C000000000000000000000000011
1000111110C00000C0000000000000011
100000000000001110000000000000111
100000000000001110000000000000111
1000111110C00000C000C000000000011
100000000000001110000000000000011
1000111110C00000C000C000000000011
1000E000000C000000000000000000011
1000111110C00000C000000000000C011
100000000000001110000000000000011
1000111110C00000C000C000000000011
100000000000001110000000000000011
111111111111111111111111111111111